####################                
#~.......#.........#
#........+.........#
#........#.........################################
#........#.........+..............................#
###+#############################################.#
  #.#                                           #.#
  #.#                      ######################+###########
  #.##############         #................................#
  #..............#         #~...............................#
  ##############.#         #................................#
               #.#         #############################+####
               #.#                                 #........#
################+################                  #........#
#~..............................#                  #....~...#
#.......##.............##.......#                  ##########
#.......##.............##.......#############
#...............................+...........#
#.......##.............##.......###########.#
#.......##.............##.......#         #.#
#~..............................#         #.#
#################################         #.#
                                          #.#
                                          #.#
###########################################+#
#~....................#.....................#
#.....................#.....................#
#.....................#.....................#
#.....................#.....................#
#.....................#.....................#
#.....................#.....................#
#.....................#.....................#
#~....................+.....................#
#############################################
